#######################################
##                                    #
#            g                  bfte  #
##                   @          af   #
##                              f   #
#.            .                   .   #
#######################################